....................
..f........ll.......
.......llll..l......
....lll.....l.......
....l......l.....c..
....l..b...l........
....l....g..l.......
...l.......l......d.
..l...a...l.........
...ll....l..........
.....llll....e......
....................
